0-1
1111111111
1310110121
0000100001
1010010101
0401000141
1101101000
0000100010
1010501001
1100100001
0001001011
1-1
0100101011
1101110001
1101110111
0001000101
0161010101
0000000060
1110110111
1100110011
1101111011
1100110011
1-2
1100011001
1001001011
1000000001
1101010101
1110010011
1100111010
0001000010
0101110000
0100011011
0110110001
2-1
0000100001
1010010101
0001000101
1101101000
0000000110
1010001001
1100100001
0001001101
0100001011
1100110001
2-2
0000100001
1010010101
0001000101
1101101000
0000100110
1010001001
1100100001
0001001101
0100001011
1100110001